1111111111
1P1CE01001
1000101001
1010P01101
10010000P1
1010011101
1001000101
10011111E1
10C000P001
1111111111